1111111
1000001
1000001
10P0E01
1000001
1C00001
1111110
