1111110
1000E01
1000001
10P0001
1000001
1C00001
1111111
