1111111
1000E01
1000001
10P0001
1000001
1C00001
0111111
