0111111
10E0001
1000001
10P0001
1000001
1C00001
1111111