1111111
1000001
100E001
10PJ001
1000001
1C00001
J111111