11111111
1000001
100E001
10P0001
1000001
1C00001
1111111
