1111111
10000P1
1000E01
10P0001
1000001
1C00001
1111111
