1111111
1000001
10E0001
1000001
1000001
1C00001
1111111