1111111
1000001
1000001
10P0E01
1100001
1C10001
1111111