1111111
1000001
1010E01
11P1001
1010C01
1000001
1111111