1111111
1000001
1000001
10P1E01
101C101
1001001
1111111