1111111
1000001
10C0001
10P0E01
1101001
1C1C101
1111111