1111111
1000001
1000101
10P1E11
1000101
1C00001
1111111