1111111111111111111111
1000000000000000000001
1000000000000000000001
1000000000000000000001
1000000000000000000001
1000000000000000000001
1000000000000000000001
1000000000000000000001
1000000000000000000001
1000P00000000000000001
100000000E000000000001
1000000000000100000001
1000001000000000000001
1000000000000000000001
1000000000000000000001
1000000000000000000001
1000000000000000000001
1000000000000000000001
1000000000000000000001
1000000000C00000000001
1000000000000000000001
1000000000000010000001
1000000000000000000001
1000000000000000000001
1000000000000000000001
1000000100000000000001
1000000000000000000001
1000010000000000000001
1000000000000000000001
1000000000000000000001
1000000000000000000001
1000C00000000000000001
100000000C000000000001
1000000000000000000001
1000000000000000000001
1000000000000001000001
1000000000000000000001
1000010000000000000001
1000000000000000000001
1000000000000000000001
1000000000000000000001
1000000000C00000000001
1000000000000000000001
1000000000000000000001
1111111111111111111111