111111111111111111
100000000000000001
100000000000000001
100000000000000001
100000000000000001
100000000000000001
100000000000000001
100000000000000001
100000000000000001
1000P0000000000001
100000000E00000001
100000000000000001
100000000000000001
100000000000000001
100000000000000001
100000000000000001
100000000000000001
100000000000000001
100000000000000001
1000000000C0000001
100000000000000001
100000000000000001
111111111111111111
